4 2 2 2 2 2 2 5 4 2 2 2 2 2 2 5 
3 0 0 0 0 0 0 3 3 0 0 0 0 0 0 3 
3 0 9 2 2 10 0 3 3 0 9 2 2 10 0 3 
3 0  0 0 0 0 0 7 6 0 0 0 0 0 0 3 
3 0 11 0 4 10 0 0 0 0 9 5 0 11 0 3 
3 0 3 0  3 16 0 4 5 0 16 3 0 3 0 3 
3 0 3 0  3 0 4 6 7 5 0 3 0 3 0 3 
3 0 8 0 8 0 3 99 99 3 0 8 0 8 0 3 
3 0 0 0 0 0 7 2 2 6 0 0 0 0 0 3 
7 5 0 11 0 0 0 0 0 0 0 0 11 0 4 6 
4 6 0 8 0 4 10 99 99 9 5 0 8 0 7 5 
7 5 0 0 0 3 99 99 99 99 3 0 0 0 4 6 
4 6 0 11 0 7 2 2 2 2 6 0 11 0 7 5 
3 0 0 3 0 0 0 0 0 0 0 0 3 0 0 3 
3 0 4 6 0 9 5 0 0 4 10 0 7 5 0 3 
3 0 8 0 0 16 13 10 0 3 16 0 0 8 0 3 
3 0 0 0 11 0 8 0 0 8 0 11 0 0 0 3 
13 10 0 9 6 0 0 0 0 0 0 7 10 0 9 14 
3 0 0 0 0 0 9 12 12 10 0 0 0 0 0 3 
3 0 9 10 0 0 0 3 3 0 0 0 9 10 0 3 
3 0 0 0 0 11 0 3 3 0 11 0 0 0 0 3 
3 0 9 2 2 6 0 7 6 0 7 2 2 10 0 3 
3 0 0 0 0 0 0 0 0 0 0 0 0 0 0 3 
7 2 2 2 2 2 2 2 2 2 2 2 2 2 2 6  